a	adjective	-
abate	adjective	niu bu ji le
abate	verb	to put an end to; nullify
abeyance	noun	a lapse in succession during which there is no person in whom a title is vested
abeyance	noun	a lapse in succession during which there is no person in whom a title is vested
abeyance	noun	a lapse in succession during which there is no person in whom a title is vested
abjure	verb	to renounce upon oath; to reject solemnly
abrogate	verb	to abolish by authoritative action; annul
abstruse	adjective	difficult to comprehend; obscure
acarpous	adjective	effete; no longer fertile; worn out
accretion	noun	the process of growth or enlargement by a gradual buildup; increase by external addition or accumulation (as by adhesion of external parts or particles); the increase of land by the action of natural forces
agog	adjective	full of intense interest or excitement; eager
agog	adverb	sas asa sa sa
alloy	noun	the mixture of disparate elements
amortize	verb	to pay off (as a mortgage) gradually, usually by periodic payments of principal and interest or by payments to a sinking fund
aplomb	noun	complete and confident composure or self-assurance; poise
apostasy	noun	renunciation of a religious faith
apostate	noun	one who abandons long-held religious or political convictions
apposite	adjective	highly pertinent, relevant, or appropriate
approbation	noun	approval
arabesque	adjective	Arabian in fashion
argot	noun	an often more or less secret vocabulary and idiom peculiar to a particular group
ascetic	adjective	practicing strict self-denial as a measure of personal and especially spiritual discipline
asperity	noun	rigor, severity
sada	adjective	dssadasvv dsffds
sdas	adjective	sdadasd sdasdasd
zz	adjective	asdasdsa zhen de sha bei a
zz	verb	Assad
